00000000000000000
02111111011101110
01100010011111110
01001010011111110
00011111111000000
01010011001111000
01011111011101130
00000000000000000
